boiled = зварене
roast = запечене
baked = вип≥чка
grilled = гриль
fried = посмажене
steamed = приготовлене на пару 
crab = краб
prawns = креветки
salmon = лосось
cabbage = капуста
lemon = лемон
pork = свина
beef = €ловичина
lamb = €гн€
duck = качка
cucumber = ог≥рок
melon = дин€
watermelon = кавун
raspberry = малина
beetroot = бур€к
cherry = вишн€
grapes = виноград
peach = персик
pear = груша
beans = квасол€
grеen beans = горох
eggplant = баклажан
pepper = перець
raw = сирий
plumbs = сливи
spoon = ложка
fork = вилка